WWWWWWWWWWWWWWWWWWWW
WSGDTGGGGGGGGGGGGGGW
WGPGGDSGGGGGGGGGSSTW
WGGGGGGGSDGGGGGGGGGW
WWWWGGGGGGGSGGGGGGGW
WTDWGGGGSGSGGGGGGGGW
WWWWGGWWWGGGSGGGGWWW
WGGGGGWDWGGDSGGGGWEW
WWWWWWWWWWWWWWWWWWWW